g g g g g g g g g g g g g g g g g g g g g g g g g g g g g g
g r r r r r r r r r r r r r r r r r r r r r r r r r r r r g
g r g g g g g g g g g g g g g g g g g g g g g g g g g g r g
g r g R1 g R2 g C1 g C2 g I1 g I2 g S1 g S2 g S3 g U1 g U2 g P1 g g r g
g r r r r r r r r r r r r r r r r r r r r r r r r r r r r g
g r g g g g g g g g g g g g g g g g g g g g g g g g g g r g
g r g r r g g r r g r r g r g g g r g g g g g g g g g g r g
g r g r r g g r g g g r g r r g r r g g g g g g g g g g r g
g r g g g g g g g g g g g g g g g g g g g g g g g g g g r g
g r g g r g g g r g r g g g g g g g g g g g g g g g g g r g
g r g r r r g g g r g g g g g g g g g g g g g g g g g g r g
g r g g r g g g r g r g g g g g g g g g g g g g g g g g r g
g r g g g g g g g g g g g g g g g g g g g g g g g g g g r g
g r g g g g g g g g g g g g g g g g g g g g g g g g g g r g
g r g g g g g g g g g g g g g g g g g g g g g g g g g g r g
g r g g g g g g g g g g g g g g g g g g g g g g g g g g r g
g r g g g g r r r r r r r r r r r r r g g g g g g g g g r g
g r g g g g r g g g g r g g g g g g r g g g g g g g g g r g
g r g g g g r g g g r r r r r r r r R2 g g g g g g g g g r g
g r g r r r r g r r r g r g g r g g r g g g g g g g g g r g
g r g r g g g g r g r g r g r r r r r g g g g g g g g g r g
g r g r g g g r r g r r r r r g g g r g g g g g g g g g r g
g r g r g g g r g g g g g g r g g g r g g g g g g g g g r g
g r g R1 r r r r r r g g g r r r r r r g g g g g g g g g r g
g r g g g g g g g r r r r r g g r g g g g g g g g g g g r g
g r g g g g g g g g g g g r r r r C1 g g g g g g g g g g r g
g r g R1 g R2 g g g g g g g g g g g g g g g g g g g g g g r g
g r g g g g g g g g g g g g g g g g g g g g g g g g g g r g
g r r r r r r r r r r r r r r r r r r r r r r r r r r r r g
g g g g g g g g g g g g g g g g g g g g g g g g g g g g g g